{
	"floor": 5,
	"layout": 
		[
			[4, 4, 4, 4, 4, 4, 4, 4, 4],
			[4, 4, 4, 4, 4, 4, 4, 4, 4],
			[4, 4, 4, 4, 5, 4, 4, 4, 4],
			[4, 4, 4, 4, 5, 4, 4, 4, 4],
			[4, 4, 4, 4, 5, 4, 4, 4, 4],
			[4, 4, 5, 4, 5, 4, 4, 4, 4],
			[4, 4, 3, 4, 5, 4, 4, 4, 5],
			[4, 3, 3, 4, 1, 4, 4, 4, 5],
			[4, 3, 3, 4, 1, 4, 4, 4, 4],
			[4, 3, 3, 4, 5, 4, 4, 4, 4],
			[4, 4, 4, 4, 5, 4, 4, 4, 4],
			[4, 4, 4, 4,12, 4, 4, 4, 4],
			[4, 4, 4, 4, 4, 4, 4, 4, 4]
		],
    "bloques": [8, 8, 8, 8, 8]
}