{
	"floor": 6,
	"layout": 
		[
			[4, 4, 4, 4, 4, 4, 4, 4, 4],
			[4, 6, 4,11,10, 3, 3, 3, 4],
			[4, 6, 4,11,10, 4, 4, 3, 4],
			[4, 6, 4,11,10, 4, 3, 3, 4],
			[4, 6, 4,11,10, 4, 3, 4, 4],
			[4, 6, 4, 4, 6, 4, 3, 3, 4],
			[4, 6, 6, 4, 4, 4, 4, 3, 4],
			[4, 3, 3, 3, 3, 3, 3, 3, 4],
			[4, 3, 3, 3, 2, 4, 4, 4, 4],
			[4, 3, 3, 3, 2, 2, 6, 6, 4],
			[4, 3, 3, 3, 2, 4, 6, 6, 4],
			[4, 3, 3, 3, 3, 4, 6,12, 4],
			[4, 4, 4, 4, 4, 4, 4, 4, 4]
		],
    "bloques": [1, 1, 1, 1, 1]
}