{
    "floor": 7,
    "layout": 
        [
            [4, 4, 4, 4, 4, 4, 4, 4, 4],
            [4, 0, 0, 0, 0, 0, 7, 7, 4],
            [4, 7, 7, 7, 7, 0,10,10, 4],
            [4, 7, 7, 7, 7, 0,10,10, 4],
            [4, 7, 7, 7, 7, 0,10,10, 4],
            [4, 7, 7, 7, 7, 7,10,10, 4],
            [4, 7, 9, 9, 7, 7, 7, 7, 7],
            [4, 7, 9, 9, 7, 7, 7, 7, 7],
            [4, 7, 9, 9, 4, 4, 4, 4, 4],
            [4, 7, 9, 9, 7, 7, 7, 7, 4],
            [4,11,11,11, 7, 7, 7, 7, 4],
            [4,11,11,11, 7, 9, 9, 9, 4],
            [4, 4, 4, 4, 4, 4, 4,12, 4]
        ],
    "bloques": [5, 1, 4, 4, 1]
}