{
    "floor": 7,
    "layout": 
        [
            [4, 4, 4, 4, 4, 4, 4, 4, 4],
            [4, 0, 0, 0, 7, 7, 1, 1, 4],
            [4, 0, 0, 0, 7, 7, 1, 1, 4],
            [4, 0, 0, 7, 7, 7, 7, 7, 4],
            [4, 0, 0, 7, 7, 7, 7, 7, 4],
            [4, 0, 7, 7, 7, 7, 7, 7, 4],
            [4, 7, 7, 7, 7, 7, 7, 7, 4],
            [4, 7, 7, 7, 7, 7, 9, 7, 4],
            [4, 7, 7, 7, 7, 9, 4, 9, 4],
            [4, 7, 7, 7, 7, 7, 9, 7, 4],
            [4, 7, 7, 7, 9, 7, 7, 7, 4],
            [4, 7, 7, 9, 9, 9, 7, 7, 4],
            [4, 4, 4, 4,12, 4, 4, 4, 4]
        ],
    "bloques": [4, 4, 1, 8, 8]
}