{
    "floor": 7,
    "layout": 
        [
            [4, 4, 4, 4, 4, 4, 4, 4, 4],
            [4, 4, 4, 4, 4, 4, 4, 4, 4],
            [4, 4, 4, 4, 7, 4, 4, 4, 4],
            [4, 4, 4, 4, 7, 4, 4, 4, 4],
            [4, 4, 4, 4, 7, 4, 4, 4, 4],
            [4, 4, 7, 4, 7, 4, 4, 4, 4],
            [4, 4, 3, 4, 7, 4, 4, 4, 7],
            [4, 3, 3, 4, 9, 4, 4, 4, 7],
            [4, 3, 3, 4, 9, 4, 4, 4, 4],
            [4, 3, 3, 4, 7, 4, 4, 4, 4],
            [4, 4, 4, 4, 7, 4, 4, 4, 4],
            [4, 4, 4, 4,12, 4, 4, 4, 4],
            [4, 4, 4, 4, 4, 4, 4, 4, 4]
        ],
    "bloques": [4, 4, 1, 8, 8]
}