{
    "floor": 6,
    "layout": 
        [
            [4, 4, 4, 4, 4, 4, 4, 4, 4],
            [4, 0, 0, 0, 6, 6, 1, 1, 4],
            [4, 0, 0, 0, 6, 6, 1, 1, 4],
            [4, 0, 0, 6, 6, 6, 6, 6, 4],
            [4, 0, 0, 6, 6, 6, 6, 6, 4],
            [4, 0, 6, 6, 6, 6, 6, 6, 4],
            [4, 6, 6, 6, 6, 6, 6, 6, 4],
            [4, 6, 6, 6, 6, 6, 2, 6, 4],
            [4, 6, 6, 6, 6, 2, 4, 2, 4],
            [4, 6, 6, 6, 6, 6, 2, 6, 4],
            [4, 6, 6, 6, 2, 6, 6, 6, 4],
            [4, 6, 6, 2, 2, 2, 6, 6, 4],
            [4, 4, 4, 4,12, 4, 4, 4, 4]
        ],
    "bloques": [4, 4, 1, 8, 8]
}