{
    "floor": 5,
    "layout": 
        [
            [4, 4, 4, 4, 4, 4, 4, 4, 4],
            [4, 3, 3, 3, 5, 5, 1, 1, 4],
            [4, 3, 3, 3, 5, 5, 1, 1, 4],
            [4, 3, 3, 5, 5, 5, 5, 5, 4],
            [4, 3, 3, 5, 5, 5, 5, 5, 4],
            [4, 3, 5, 5, 5, 5, 5, 5, 4],
            [4, 5, 5, 5, 5, 5, 5, 5, 4],
            [4, 5, 5, 5, 5, 5, 0, 5, 4],
            [4, 5, 5, 5, 5, 0, 4, 0, 4],
            [4, 5, 5, 5, 5, 5, 0, 5, 4],
            [4, 5, 5, 5, 0, 5, 5, 5, 4],
            [4, 5, 5, 0, 0, 0, 5, 5, 4],
            [4, 4, 4, 4,10, 4, 4, 4, 4]
        ],
    "bloques": [4, 4, 1, 8, 8]
}