{
	"floor": 5,
	"layout": 
		[
			[4, 4, 4, 4, 4, 4, 4, 4, 4],
			[4, 0, 0, 0, 0, 0, 5, 5, 4],
			[4, 5, 5, 5, 5, 0, 5, 5, 4],
			[4, 5, 5, 5, 5, 0, 5, 5, 4],
			[4, 5, 5, 5, 5, 0, 5, 5, 4],
			[4, 5, 5, 5, 5, 5, 5, 5, 4],
			[4, 5, 3, 3, 5, 5, 5, 5, 5],
			[4, 5, 3, 3, 5, 5, 5, 5, 5],
			[4, 5, 3, 3, 4, 4, 4, 4, 4],
			[4, 5, 3, 3, 5, 5, 5, 5, 4],
			[4, 5, 5, 5, 5, 5, 5, 5, 4],
			[4, 5, 5, 5, 5, 3, 3, 5, 4],
			[4, 4, 4, 4, 4, 4, 4, 4, 4]
		],
    "bloques": [1, 1, 0, 3, 1]
}