{
    "bioma": 0,
    "tileset": {
        "0": [200, 200, 255],
        "1": []
    },
    "puerta": [2, 4],
    "alto": 20,
    "ancho": 20,
    "tile_size": 48,
    "mapa": [
        [0,0,0,0,0,0,0,0,0,0,0,0,0,0,0,0,0,0,0,0],
        [0,0,0,0,0,0,0,0,0,0,0,0,0,0,0,0,0,0,0,0],
        [1,1,1,1,1,2,1,1,1,1,1,1,2,1,1,2,1,1,1,1],
        [1,1,0,0,1,1,1,1,1,1,1,1,1,1,1,1,1,1,1,1],
        [1,0,0,0,0,1,1,1,1,1,1,1,1,1,1,1,1,1,1,1],
        [1,1,1,1,1,1,1,1,1,1,1,1,1,1,1,1,1,1,1,1],
        [3,3,3,3,3,3,3,3,3,3,3,3,3,3,3,3,3,3,3,3],
        [3,3,3,3,3,3,3,3,3,3,3,3,3,3,3,3,3,3,3,3],
        [3,3,3,3,3,3,3,3,3,3,3,3,3,3,3,3,3,3,3,3],
        [3,3,3,3,3,3,3,3,3,3,3,3,3,3,3,3,3,3,3,3],
        [3,3,3,3,3,3,3,3,3,3,3,3,3,3,3,3,3,3,3,3],
        [3,3,3,3,3,3,3,3,3,3,3,3,3,3,3,3,3,3,3,3],
        [3,3,3,3,3,3,3,3,3,3,3,3,3,3,3,3,3,3,3,3],
        [3,3,3,3,3,3,3,3,3,3,3,3,3,3,3,3,3,3,3,3],
        [4,4,4,4,4,4,4,4,4,4,4,4,4,4,4,4,4,4,4,4],
        [4,4,4,4,4,4,4,4,4,4,4,4,4,4,4,4,4,4,4,4],
        [4,4,4,4,4,4,4,4,4,4,4,4,4,4,4,4,4,4,4,4],
        [4,4,4,4,4,4,4,4,4,4,4,4,4,4,4,4,4,4,4,4],
        [4,4,4,4,4,4,4,4,4,4,4,4,4,4,4,4,4,4,4,4],
        [4,4,4,4,4,4,4,4,4,4,4,4,4,4,4,4,4,4,4,4]
    ]
}